1111111111111111111111111111111111111111111111111111111111111111111111111111111111
10001000C0000000000000000000000000000000000000000000000000000000000000000000000001
1000000CCC000000000000000000000000000000000000000000000000000000000000000000000001
101000CCCCC00000000000000000000000000000000000000000000000000000000000000000000001
10000CCCCCCC0000P00000000000000000000000000000000000000000000000000000000000000001
1111111111111111111100000000000000000000000000000000000000000000000000000000000001
1000000000000000000010000000000000000000000000000000000000000000000000000000000001
1000000000000000000001100000000000000000000000000000000000000000000000000000000001
1000000000000000000000000000000011111110000000000000000000000000000000000000000001
1000000000000000000000000000000000000000000000000000000000000000000000000000000001
1000000000000000000000001111000000000000000000000000000000000000000000000000000001
1000000000000000000000000000000000000000000000000000000000000000000000000000000001
1000000000000000000000000000000000000000000000000000000111000000011110000000000001
1111111111111111000000000000000000000000000000000000000000000000000000000000000001
1000000000000000000000000001111111111000000000000000000000000000000000000000000001
1000000000000000000000000000000000000000000000000111111111111111111111111111111111
1000000000000000000000000000000000000000000000000000000000000000000000000000000001
1000000000000000000000000000000000000000000000000000000000000000000000000000000001
1000000000000000000000000000000000000000000111000000000000000000000000000000000001
1000000000000000000000000000000000000000000000000000000000000000000000000000000001
1000000000000000000000000000000000000000000000000000000000000000000000000000000001
1000000000000000000000000000000000000011000000000000000000000000000000000000000001
1000000000000000000000000000000000000000000000000000000000000000000000000000000001
1000000000000000000000000000000000000000000000000000111100000000000000000000000001
1000000000000000000000000000000000000000000000000000000000000000000000000000000001
1000000111100000000000000000000000000000000000000000000000000011100000000000000001
1000000000000000000000000000000000000000000000000000000000000000000000000000111111
10000000000E0000000000000000000000000000000000000000000000000001110000000000000E01
10000000000000000000000000N0000000000000000000000000000000000000000000000000100001
1111111111111111111111111111111111111111111111111111111111111111111111111111111111
