11111111111111111111111111111111111111111111111111111111111111111111111111111111111111111111111111111111111111111111111111111111111111111111111111111111111
10000000000000000000000000000000000000000000000000000000000000000000000000000000000000000000000000000000000000000000000000000000000000000000000000000000001
10000000000000000000000000000000000000000000000000000000000000000000000000000000000000000000000000000000000000000000000000000000000000000000000000000000001
10000000000000000000000000000000000000000000000000000000000000000000000000000000000000000000000000000000000000000000000000000000000000000000000000000000001
100000000000000000000000000000000000000000000000000000000000000000000000000000000000000000C0000000000000000000000000000000000000000000000000000000000000001
1000000000000000000000000000000000000000000000000000000000000000000000000000000C000000000000000000000000000000000000000000000000000000000000000000000000001
1000000111111111000000000000000000000000000000C00000000000000000000000000000000000000000000000000C000000000000000000000000000000000000000000000000000000001
100000000000000010000000000000000000000000000000000000000000000000000C0000000000000000000000000000000000000000000000000000000000000000000000000000000000001
10000000000000000111111111111111111110000000011100000000011110000000011111111111111111111111111111110000000000000000000000000000000000000000000000000000001
11000000000000000100000000000000000000000000000000000000000000000000000011111111111111111111111111111100000000000000000000000000000000000000000000000000001
10000000000000000100000000000000000000000000000000000000000000000000000011100000000000000000000000001111000000000000000000000000000000000000000000000000001
100000011000000001000000000000000000000000000000000000000000000000000000111000000000000000C0000000000011110000000000000000000000000000000000000000000000001
10000000000000001100000000000000000000000000000000000000000000000000000011100000000000000011000000000000111100000000000000000000000000000000000000000000001
1000000000000000010E000000000000000000000000000000000000000000000000000011100000000000000011000000000000001111000000000000000000000000000000000000000000001
10000000000000000100000000000000000000000000000000000000000000000000000011100000000000000011110000000000000011110000000000000000000000000000000000000000001
10000000000000000111100000000000000000000000000000000000000000000000000011100000000000000011000000000000000001111100000000000000000000000000000000000000001
100000000C0000000100000000000000000000000000000000000000000000000000000011100000000000000011000000000000000001111111000000000000000000000000000000000000001
10000000011000000100100000000000000000000000000000000000000000000000000011100000000000000011111111000000000001111111110000000000000000000000000000000000001
10000000000000000100000000000000000000000000000000000000000000000000000001100000000000000011000000000001100001111111111100000000000000000000000000000000001
10000000000000000100000000000000000000000000N00000000000000000000000000001100000000000000011000000000000000001111111111111000000000000000000000000000000001
1C000000000000000111111111111111111111111111111111111111111111111111111101100000000C00000011000000000000000001111111111111110000000000000000000000000000001
1100000000000000000000000000000000000010000000000000000000000000000000000110000000CCC0000011000000000000000001111111111111111100000000000000000000000000001
1011000000000000000000000000000000000C1000000000000000000000000000000000011000000CCCCC000011000000000000000000000000000000000000000000000000000000000000001
10000000000000000100000000000000000000100111111111111111111111111111111111100000CCCCCCC00011000000000000000000000000000000000000000000000000000000000000001
10000000000110000111111111111111111111100111111111111111111111111111111111101111111111111111111111111111111111111111111111111111111111111111111111111111111
10000000000000000111111111111111111111100110000000000000000000000000000000001111111111111111111111111111111111111111111111111111111111111111111111111111111
100000000000000001111111EEE111EEE11111100110000000000000000000000000000000001100000000000000000000000000000000000000000000000000000000000000000000000000001
100C0000000000000111111E000E1E000E1111100110011111111111111111111111111111111100000111100001111100100000100111111001111110010000000001000000000000000000001
111111000000000001111110E110E011E01111100110011111111111111111111111111111111100001000010010000010010001000100000001000010010000000001000000000000000000001
1000000000000000011111110E11011E011111100110011000000000000000000000000000000000001000010010000000001010000100000001000010001000000010000000000000000000001
10000000000000000111111110E111E0111111100110011000000000000000000000000000000000001111100001111100000100000100000001000010001000100010000000000000000000001
100000000000111111111111110E1E01111111100110011000000000000000000000000000000000001000000000000010000100000100000001000010000100100100000000000000000000001
10C0000000000000011111111110E011111111100110011000011111111111111111111111100000001000000010000010000100000100000001000010000101010100000000000000000000001
10000000000000000111111111110111111111100110011000000000000000000000000000111000001000000001111100000100000111111001111110000010001000000000000000000000001
11111000000000000111111111111111111111100110011000000000000000000000000000001110000000000000000000000000000000000000000000000000000000000000000000000000001
10000000000000C00111111111111111111111100110011000000000000000000C00000000000011100000000000000000000000000000000000000000000000000000000000000000000000001
10000000000000000111111111111111111111100110011000000000000000000000000000000000111000000000000000000000000000000000000000000000000000000000000000000000001
10000000011111111111111111111111111111100110011000000000000000000000000000000000001111111111111111111111111111111111111111111111111111100000000000000000001
100C0000000000000111111111111111111111100110011000000000000000000000000000000000000000000000000000000000000000000000000000000000000000011100000000000000001
10000000000000000000000000000000000000000000000000000000000000000000000000000000000000000000C000000000C0000C000000000000C0000000000C00000111000000000P00001
1000000000000000000000000000000000000000C000C00000000000000000000000000000000000000000000000000000000000000000000000000000000000000000000001110000000000001
11111111111111111111111111111111111111111111111111111111111111111111111111111111111111111111111111111111111111111111111111111111111111111111111111111111111
