111111111
1PCE10001
111111111
