1111111111111111111111111
1000000000000000000000001
1000000000000000000000001
1000000000000000000000001
10000000000E0C00000000001
100000000000P000000000001
1000000000001000000000001
1111111111111111111101111
0000000000000000000101000
0000000000000000000101000
0000000000000000000111000
0000000000000000000000000
000000000000N000000000000
1111111111111111111111111
0000000000000000000000000
