11111111111111
1000C001000001
1E000001000001
10000001000001
10000001000001
10000001000001
00000010100001
00000100P10001
11111111111111